11111111111111111
10P000000M0000C01
1MMMMMMM000MMMM01
1C000000MMMMM0001
10M00000M000M0MM1
10000M00C0M000E01
11111111111111111
