1111111111111
10C10000000C1
1011001111101
1P0001E000001
1111111111111
