111111111111111111111111111111111111111111111
1001000000000000000000000000000000000000000C1
100001111100000000000000000000000000000000001
100011E00000000000000000000000000000000000001
101111111111000000000000000000000000000000001
1001000000000000000000000000000000000000000C1
100000000000000000000000000000000000011111001
1P0011E00000000000000000000000000000000000001
111111111111111111111111111111111111111111111
