1111111111111
100100000000C1
100001111100111
1P0011E0000001
1111111111111
